2222222222222222222333333555555555555555
2222222222222222222333333555555555555555
2222222222222222222333333555555555555555
2222222222222222222333333555555555555555
2222222222222222222333333555555555555555
2222222222222222222333333555555555555555
2222222222222222222333333555555555555555
2222222222222222222333333555555555555555
2222222222222222222333333555555555555555
2222222222222222222333333555555555555555
2222222222222222222333333555555555555555
2222222222222222222333333555555555555555
2222222222222222222333333555555555555555
2222222222222222222333333555555555555555
2222222222222222222333333555555555555555
2222222222222222222333333555555555555555
2222222222222222222333333555555555555555
3333333333333333333333333333333333333333
3333333333333333333333333333333333333333
3333333333333333333333333333333333333333
3333333333333333333333333333333333333333
1111111111111111111333333444444444444444
1111111111111111111333333444444444444444
1111111111111111111333333444444444444444
1111111111111111111333333444444444444444
1111111111111111111333333444444444444444
1111111111111111111333333444444444444444
1111111111111111111333333444444444444444
1111111111111111111333333444444444444444
1111111111111111111333333444444444444444
1111111111111111111333333444444444444444
1111111111111111111333333444444444444444
1111111111111111111333333444444444444444
1111111111111111111333333444444444444444
1111111111111111111333333444444444444444
1111111111111111111333333444444444444444
1111111111111111111333333444444444444444
1111111111111111111333333444444444444444
1111111111111111111333333444444444444444
1111111111111111111333333444444444444444
