22222222222222225555555555555555
22222222222222223355555555555555
22222222222222223355555555555555
22222222222222223355555555555555
22222222222222223355555555555555
22222222222222223355555555555555
22222222222222223355555555555555
22222222222222223355555555555555
22222222222222223355555555555555
22222222222222223355555555555555
22222222223333333355555555555555
22222222223333333355555555555555
22222222223333333355555555555555
22222222223333333355555555555555
22222222223333333355555555555555
22222222223333333355555555555555
11111111113333333344444444444444
11111111113333333344444444444444
11111111113333334444444444444444
11111111113333334444444444444444
11111111113333334444444444444444
11111111113333334444444444444444
11111111113333334444444444444444
11111111113333334444444444444444
11111111113333334444444444444444
11111111113333334444444444444444
11111111113333334444444444444444
11111111113333334444444444444444
11111111113333334444444444444444
11111111111111114444444444444444
11111111111111114444444444444444
11111111111111114444444444444444