11111111111111111111111111111111
10000000000000000000000000000001
10000000000000000000000000000001
10002222200000000000000000000001
10002000200000000000000000p00001
10002000200000000000000000000001
10002000200000000000000000000001
10002222200000333330000000000001
10000000000000300030000000000001
10000000000000300030000000000001
10000000000000300030000000000001
10000000000000333330000000000001
1000000000000000000M000000000001
10000000000000000000000000000001
11111111111111111111111111111111