11111111111111111111111111111111
10000000000000000000000000000001
10000000000000000000000000000001
10001111100000000000000000000001
10001000100000000000000000p00001
10001000100000000000000000000001
10001000100000000000000000000001
10001111100000111110000000000001
10000000000000100010000000000001
10000000000000100010000000000001
10000000000000100010000000000001
10000000000000111110000000000001
10000000000000000000000000000001
10000000000000000000000000000001
11111111111111111111111111111111