1111111111111111111111111111111111111111
1p00000000000000010000000000000000000001
1011111111111110101111111111111111111101
1010000000000010101000000000000000000101
101011111111010101011111111111111110101
101010000001010000000000000000000010101
10101011101011111111111111111111010101
10001010101000000000000000000001010101
11101110111111111110000111111111011101
10000000000000000010000100000000000001
10222222220222222010000103333333333301
10200000020200002010000103000000000301
10202220020202202010000103033333300301
10202020020202002011001103030000300301
10202220020222002000000003030300300301
10200000020000002222002222030300300301
10222222222222000000000000033300333301
10000000000002222220022222200000000001
11111111111111111110011111111111111111
10000000000000000000000000000000000001
10555555555555555110011444444444444401
10500000000000005110011400000000000401
1050555555555505110011404444444440401
1050500000000505110011404000000040401
105050555550050500000004040444040401
1050505000500505000000040404M4040401
105050555050050555505555040444040401
105050000050050000000000040000040401
105055555550055555505555544444440401
105000000000000000000000000000000401
105555555555555555505555555555555401
100000000000000000000000000000000001
111111100111111111100111111111111111
100000100100000000100100000000100001
1011101001011111010010111110100101
10100000010100000000000000010100001
101011111101011111111111111010111101
101000000001000000000000000001000001
101111111111111111111111111111111111
111111111111111111111111111111111111