22222222222222225555555555555555
20000020002000003050000000500005
20222020202022203050555550505505
20200000200000203050500050505005
20202222222220203050505050505055
20202000000000203050505050500005
20202022222222203050505055555505
20200020000000003050005000000005
20222220222222203055555555555505
20000000200000003050000000005005
20222222203333333050555555505055
20000000203000000050500000505055
20222220203033333050505550505055
20200000003000003050505050505005
20222222203033303050505050505555
20000000003000300050500000000005
10111111103330333350555555555555
10100000000000000000000040000004
10101111103333304444444040444404
10100000103000304000004040400004
10111110103030304044404040404444
10100000103030304040004040400004
10101111103030304040444040444044
10100000003030304040000040000004
10111111103030304044444444444404
10000000103030304000000000000004
11111110103030304444444444444404
10000010103030304000000000000004
10111010100000004044444444444404
10100010111111114040000000000004
1p101000000000000040444444444444
11111111111111114444444444444444