2222222222222222222333333555555555555555
200020000000200000000000350505050505C505
2022202222202022202300003505050505050505
202C002000202020202300003505050500050505
2020222020222020202300003505050555550505
2020002020000020002300003505000000000505
2022202022222222202300003505555555555505
2000000000200000002300000005000000000005
2022222220202222222300333505055555555555
2020000020000000002300003505050005000505
2020222022222222202333303505050505050505
2020002000002000202300003505050505050505
2022202222202020202300303505050505050505
20002000000020202023003035000000050505M5
2022222222222020202333303555555555055555
2000000000000020002300003500000000000005
2022222222222222202300333555555555555505
3033333333333333303333003333333333333303
3030003000000003000300000003000000000003ssss
3000300000300000000000000000030000030303
3333333330333333333303003333333333330333
1111111110111111111303333444444444440444
1000001000001000001333003400000000040004
101110101110101110130300340444444404C404
1010000010100010101303303404000004040404
1010111110111110101300003404044404040404
1010100000000000101303003404040004040404
1010101111111111101303003404040444040404
1010001000000000001300000004000000000404
1011101011111111111333003404444444444404
1010101000001000001303003404000000000004
1010101111101011101303003404044444444404
1010000000100010101303003404000000000404
1011111110111110101300003404444444440404
1000001000000000001300333400000400000004
1011101011111111111300303444440404444404
10p0001000000000001300003400000400000004
1011111111111111101303333404444444444404
1000000000000000000000000000000000000004
1111111111111111111333333444444444444444