1111111111111111111111111111111111111111111111111111111111111111
1p00000000001000000000002000000000001000000000000000000000000001
1011111111101011111222202011111111101011111111111111111111111101
1010000000001010000000202010000000101000000000000000000000000101
1010111111111010111110202010111110101111111111111111111111110101
1010100000000010100020000010000010100000000000000000000000010101
1010101111111110101022222211111010111111111111111111111111010101
1010101000000000101000000000001010000000000000000000000001010101
1010101011111111101111111111101010111111111111111111111101010101
1010001000000000000000000000101010000000000000000000000101010101
1011111111111111111111111110101011111111111111111111110101010101
1000000000003000000000000010101000000000000000000000010101000101
1111111111103011111111111010101111111111111111111111010101111101
1000000000103010000000001010101000000000000000000001010000000001
1033333330103010333333301010101033333333333333333301011111111111
1030000030103010300000301010101030000000000000000301000000000001
1030333030103010303330301010101030111111111111110301111111111101
1030303030100010303030301000101030100000000000010300000000000101
1030303030111110303030301111101030101111111111010333333333330101
1030303030000000303030300000001030101000000001010000000000030101
1033303331111111303330333111111030101011111101011111111111030101
1000000000000000000000000000000030101000000101000000000001030101
1111111111111115555511111111111110101111110101111111111101030101
1000000000000005000500000000000000100000010100000000000101030101
1055555555555505050505555555555555111111010111111111110101030101
1050000000000505050505000000000000000001010000000000010101030101
1050555555550505050505055555555555555501010555555555010101000101
1050500000050505050505050000000000000501010500000005010101111101
1050505555050500050505050555555555550501010505555505010100000001
1050505005050555550505050500000000050501010505000505010111111111
1050505055050000000505050505555555050501010505050505010000000001
1050505000050555555505050505000005050501010505050505011111111101
1050555555550000000005050505055505050501010505050505000000000101
1050000000000555555555050505050505050501010505050505555555550101
1055555555555500000000050505050505050501010505050000000000050101
1000000000000005555555550505050505050501010505055555555555050101
1111111111111114444444440505050505050501010505000000000005050101
1000000000000004000000040500050505000501010505555555555505050101
1444444444444404044444040555550505555501010500000000000505050101
1400000000000404040004040000000500000001010555555555550505050101
1404444444440404040404044444444544444441010000000000050505050101
1404000000040404040404000000000400000000011111111111050505050101
1404044444040404040404444444440404444444444444444444050505050101
1404040004040404040400000000040404000000000000000004050505050101
1404040404040404040444444444040404044444444444444404050505050101
1404040404040404000000000004040404040000000000000404050505050101
1404040404040404444444444404040404040444444444440404050505050101
1404040404040400000000000404040404040400000000040404050505050101
1404040404040444444444440404040404040404444444040404050505050101
1404040404040000000000040404040404040404000004040404050505050101
1404040404044444444444040404040404040404044404040404050505050101
1404040404000000000004040404040404040404040404040404050505050101
1404040404444444444404040404040404040404040404040404050505050101
1404040400000000000404040404040404040404040404040404050505050101
1404040444444444440404040404040404040404040404040404050505050101
1404040000000000040404040400000404040004040404040404050505050101
1404044444444444040404040444440404044404040404040404050505050101
1404000000000004040404040000040404000404040404040404000505050101
1404444444444404040404044444040404440404040404040404440505050101
1400000000000404040404000004040400040404040404040000000000000101
1444444444440404040404444404040444040404040404044444444444440101
14000000000404000404000004040400040404000400000400000000000M0101
1444444444040444040444440404044404040444044444040444444444440101
1111111111111111111111111111111111111111111111111111111111111111