1111111111111111111111111111111111111111111111111111111111111111
1p00000000001000000020002000000222000000000020000000000000000001
1011111111101011111020202022220202022222222020222222222222222201
1000000000101010000020200020020202020000002020200000000000000201
1111101110101010111120222220220202020222202020202222222222220201
1000101010100010000020000000200002020200202020200000000000020201
1010101010111111111122222222202222020202202020222222222222020201
1010001010000000000020000000002000020000002020000000000000020201
1011111011111111111020222222222022222222222020222222222222220201
1000001000000000001020200000000000000000002020200000000000000201
1111101111111111101020202222222222222222202020202222222222222201
1000100000000000101000002000000000000000200020002000000000000001
1010111111111110101111122022222222222220222222222022222222222221
1010000000000010100000020020000000000020000000000000000000000001
1011111111111010111111120220222222222022222222222222222222222221
1000003000000010000000020200000000002000000000000000000000000001
1033303033333311111111120222222222202222222222222222222222222221
1030003000000000000000000000000000200000000000000000000000000001
1030333333333333333333332222222220222222222222222222222222222221
1030000000003000000000032000000020000000000000000000000000000001
1033333333303033333333032022222022222222222222222222222222222221
1030000000303030000003032020002000000000000000000000000000000001
1030333330303030333303032020202222222222222222222222222222222221
1030300000303030300303032020200000000000000000000000000000000001
1030303333303030303303032020222222222222222222222222222222222221
1030300000003030300003002020000000000000000000000000000000000001
1030333333333030333333332022222222222222222222222222222222222221
1030000000000030000000000000000000000000000000000000000000000001
1033333333333333333333335555555555555555555555555555555555555551
1000000000000000000000005000000050000000500050000000500000000001
1111111111111111111111115055555050555550505050555550505555555551
1050000000005000500000005050005050500050505050500050505000000001
1050555555505050505555555050505050505050505050505050505055555551
1050500000505050500000005050505050505050505050505050505000000001
1050505550505050555555505050505050505050505050505050505555555551
1050505050505050000000505050505050505050005050505050500000000001
1050505050505055555550505050505050505055555050505050555555555551
1050005050505000000050500050500050505000000050505050000000000001
1055555050505555555050555550555550505555555550505055555555555551
1000000050500000000050000000000000500000000000505000000000000001
1111111111111115555554444444444444444444444444444444444444444441
1444444444444445000054000400000004000000040000000000000004000001
1400000000000005055054040404444404044444040444444444444404044441
1404444444444405055054040404000404040004040400000000000404040001
1404000000000405055054040404040404040404040404444444440404040441
1404044444440405055054040404040404040404040404000000040404040441
1404040000040400000004040404040404040404040404044444040404040441
1404040444040444444444040404040404040404040404040004040404040441
1404040404040400000000040404040404040404040404040404040404040441
1404040404040404444444440404040404040404040404040404040404040441
1404040404040404000000000404040404040404040404040404040404040441
1404040404040404044444444404040404040404040404040404040404040441
1404040404040404040000000004040404040404040404040404040404040441
1404040404040404040444444444040404040404040404040404040404040441
1404040404040404040400000000040404040404040404040404040404040441
1404040404040404040404444444440404040404040404040404040404040441
1404000400040004040404000000000404040404040404040404040404040441
1404440404040404040404044444444404040404040404040404040404040441
1400000404040404040404000000000004040404040404040004040004040441
1444444404040404040404444444444444040404040404044404044404040441
1400000004040404040400000000000000040404040404000004000004040441
1404444444040404040444444444444444440404040404444444444444040441
14000000000400040000000000000000000004000400000000000000000M0441
1111111111111111111111111111111111111111111111111111111111111111