0000000000000000000000000000000000000000000000000000000000000000
0000000000000000000000000000000000000000000000000000000000000000
0000000000000000000000000000000000000000000000000000000000000000
0000000000000000000000000000000000000000000000000000000000000000
0000000000000000000000000000000000000000000000000000000000000000
0000000000000000000000000000000000000000000000000000000000000000
0000000000000000000000000000000000000000000000000000000000000000
0000000000000000000000000000000000000000000000000000000000000000
0000000000000000000000000000000000000000000000000000000000000000
0000000000000000000000000000000000000000000000000000000000000000
0000000000000000000000000000000000000000000000000000000000000000
0000000000000000000000000000000000000000000000000000000000000000
0000000000000000000000000000000000000000000000000000000000000000
0000000000000000000000000000000000000000000000000000000000000000
0000000000000000000000000000000000000000000000000000000000000000
0000000000000000000000000000000000000000000000000000000000000000
0011111111111111111111111111111111111111111111111111111111111110
0011111111111111111111111111111111111111111111111111111111111110
0011111111111111111111111111111111111111111111111111111111111110
0011111111111111111111111111111111111111111111111111111111111110
0011111111111111111111111111111111111111111111111111111111111110
0011111111111111111111111111111111111111111111111111111111111110
0011111111111111111111111111111111111111111111111111111111111110
0011111111111111111111111111111111111111111111111111111111111110
0011111111111111111111111111111111111111111111111111111111111110
0011111111111111111111111111111111111111111111111111111111111110
0011111111111111111111111111111111111111111111111111111111111110
0011111111111111111111111111111111111111111111111111111111111110
0022222222222222222222222222222222222222222222222222222222222220
0022222222222222222222222222222222222222222222222222222222222220
0022222222222222222222222222222222222222222222222222222222222220
0022222222222222222222222222222222222222222222222222222222222220
0022222222222222222222222222222222222222222222222222222222222220
0022222222222222222222222222222222222222222222222222222222222220
0022222222222222222222222222222222222222222222222222222222222220
0022222222222222222222222222222222222222222222222222222222222220
0022222222222222222222222222222222222222222222222222222222222220
0022222222222222222222222222222222222222222222222222222222222220
0022222222222222222222222222222222222222222222222222222222222220
0022222222222222222222222222222222222222222222222222222222222220
0033333333333333333333333333333333333333333333333333333333333330
0033333333333333333333333333333333333333333333333333333333333330
0033333333333333333333333333333333333333333333333333333333333330
0033333333333333333333333333333333333333333333333333333333333330
0033333333333333333333333333333333333333333333333333333333333330
0033333333333333333333333333333333333333333333333333333333333330
0033333333333333333333333333333333333333333333333333333333333330
0033333333333333333333333333333333333333333333333333333333333330
0033333333333333333333333333333333333333333333333333333333333330
0033333333333333333333333333333333333333333333333333333333333330
0033333333333333333333333333333333333333333333333333333333333330
0033333333333333333333333333333333333333333333333333333333333330
0033333333333333333333333333333333333333333333333333333333333330
0033333333333333333333333333333333333333333333333333333333333330
0033333333333333333333333333333333333333333333333333333333333330
0033333333333333333333333333333333333333333333333333333333333330
0033333333333333333333333333333333333333333333333333333333333330
0033333333333333333333333333333333333333333333333333333333333330
0033333333333333333333333333333333333333333333333333333333333330
0033333333333333333333333333333333333333333333333333333333333330
0033333333333333333333333333333333333333333333333333333333333330
0033333333333333333333333333333333333333333333333333333333333330
0033333333333333333333333333333333333333333333333333333333333330
0000000000000000000000000000000000000000000000000000000000000000
