11111111111111111111111111111111111111111111111111111111111111111111111111111111111111111111111111111111111111111111111111111111
14444444444444444444444444444444444444444444444444444400000000000500500055044444444444444444444444444444444444444444444444444441
14444444444444444444444444444444444444444444444444444405500000000050000005544444444444444444444444444444444444444444444444444441
14444444444444444444444444444444444444444444444444444500500000000050500505004444444444444444444444444444444444444444444444444441
14444444444444444444444444444444444444444444444444444500050000000000005005504444444444444444444444444444444444444444444444444441
14444444444444444444444444444444444444444444444444440505050005555555000500005444444444444444444444444444444444444444444444444441
14444444444444444444444444444444444444444444444444440005050500000000055000050444444444444444444444444444444444444444444444444441
14444444444444444444444444444444444444444444444444400000005000000000005050505044444444444444444444444444444444444444444444444441
14444444444444444444444444444444444444444444444444405000000000000000000000000044444444444444444444444444444444444444444444444441
14444444444444444444444444444444444444444444444444500000500000000000000055550004444444444444444444444444444444444444444444444441
14444444444444444444444444444444444444444444444444550055000000000000000005500054444444444444444444444444444444444444444444444441
14444444444444444444444444444444444444444444444445500050000000000000000000050000444444444444444444444444444444444444444444444441
14444444444444444444444444444444444444444444444440005050000000000000000000550000444444444444444444444444444444444444444444444441
14444444444444444444444444444444444444444444444400000050000000000000000000000005544444444444444444444444444444444444444444444441
14444444444444444444444444444444444444444444444400050050000000000000000000000050044444444444444444444444444444444444444444444441
1444444444444444444444444444444444444444444444400000005000000000M000000000500505004444444444444444444444444444444444444444444441
14444444444444444444444444444444444444444444444050500050000000000000000000000000004444444444444444444444444444444444444444444441
14444444444444444444444444444444444444444444445555000050000000000000000000000500000444444444444444444444444444444444444444444441
14444444444444444444444444444444444444444444440005000050000000000000000000005000500444444444444444444444444444444444444444444441
14444444444444444444444444444444444444444444400055000000000000000000000000000500000544444444444444444444444444444444444444444441
14444444444444444444444444444444444444444444450000505005000000000000000005050505000044444444444444444444444444444444444444444441
14444444444444444444444444444444444444444444000500500000500000000000000050500055000054444444444444444444444444444444444444444441
14444444444444444444444444444444444444444444000000000000000000000000000050500000050554444444444444444444444444444444444444444441
14444444444444444444444444444444444444444440000500000000005000000000005000000000005500444444444444444444444444444444444444444441
14444444444444444444444444444444444444444440005000050000005500000000050050050000000000444444444444444444444444444444444444444441
14444444444444444444444444444444444444444400005000000000000050005500500000005000000050544444444444444444444444444444444444444441
14444444444444444444444444444444444444444400005005000000000000050000000500000000000000544444444444444444444444444444444444444441
14444444444444444444444444444444444444444500000505500000000000050050000005000050005000504444444444444444444444444444444444444441
14444444444444444444444444444444444444444500500050550500005550000000000005000050505000004444444444444444444444444444444444444441
14444444444444444444444444444444444444440000000000000000000000050005000005000055005050000444444444444444444444444444444444444441
14444444444444444444444444444444444444445500500000000000500500050050000505050050000500000444444444444444444444444444444444444441
14444444444444444444444444444444444444405000005000500000000500550000550050000500000500000044444444444444444444444444444444444441
14444444444444444444444444444444444444400000500000000005050000000500050000000000500005500044444444444444444444444444444444444441
14444444444444444444444444444444444444005000000005550050005000000000005000000505000500055004444444444444444444444444444444444441
14444444444444444444444444444444444444005000500500500050550005050500055000005500005550000054444444444444444444444444444444444441
14444444444444444444444444444444444440000000550500000505000000000000000500500500005500000505444444444444444444444444444444444441
14444444444444444444444444444444444445500000050000050000500000005050000505005005000005000005444444444444444444444444444444444441
14444444444444444444444444444444444400000000005005000500000000000005000000000000000500505055044444444444444444444444444444444441
14444444444444444444444444444444444400000000000005050500000055000000050005000000000000000050544444444444444444444444444444444441
14444444444444444444444444444444444000050000000000000500005050050000000005000000000000000000504444444444444444444444444444444441
14444444444444444444444444444444444000000550550000550000000005000500050000050000500000000005054444444444444444444444444444444441
14444444444444444444444444444444440000005000500000000000000000000055050050000005000500000050050444444444444444444444444444444441
14444444444444444444444444444444440000000000005000005500000000000550050050000000005050050550005444444444444444444444444444444441
14444444444444444444444444444444450000000000000050005050000505500050005000005050005000005000055044444444444444444444444444444441
14444444444444444444444444444444405000000000050500050050000000000500000000000500500000000005050044444444444444444444444444444441
14444444444444444444444444444444000500000000005500500000000055050000000000000000500000000055000004444444444444444444444444444441
14444444444444444444444444444444000000000000000500000000000000000005505000500050005000000000000004444444444444444444444444444441
14444444444444444444444444444445000500000500050500550000000500005000000005050000000050000500000050444444444444444444444444444441
14444444444444444444444444444445000005005000000000050055005000500005050000000000500005000550050000444444444444444444444444444441
14444444444444444444444444444400500000000050000000000500000000000055005000050000000005055005000500044444444444444444444444444441
14444444444444444444444444444400000050005000005000000000000005550000005050000050505500050005005000044444444444444444444444444441
14444444444444444444444444444000000000005000000005050050005050500505500005500000005505000000050000004444444444444444444444444441
14444444444444444444444444444005005050000000000000550000005000000500000500000000050000500005005055004444444444444444444444444441
14444444444444444444444444440000000050000500000005005000050000050000000000000000000005500505050000005444444444444444444444444441
14444444444444444444444444440000000005000000055050500500005000000550005000050000005005050000005000000444444444444444444444444441
14444444444444444444444444400000000005000000050000500000000000550000500000000000500500005000000005000044444444444444444444444441
14444444444444444444444444400050000000000000000000500000000005050005050005500005000555005050005050500044444444444444444444444441
14444444444444444444444444000550000000000000000000500000000000000005000500000050000000500555005000500054444444444444444444444441
14444444444444444444444444000000050000000000000000050000005000005000000000050055000000005000000000000054444444444444444444444441
14444444444444444444444440000000000005000005000005005000005555000000050000000050000000000000050000005000444444444444444444444441
10000000000000000000000000000000000000000000000000000000000000000000000000000000000000000000000000000000000000000000000000000001
10000000000000000000000000000000000000000000000000000000000000000000000000000000000000000000000000000000000000000000000000000001
10000000000000000000000000000000000000000000000000000000000000000000000000000000000000000000000000000000000000000000000000000001
10000000000000000000000000000000000000000000000000000000000000000000000000000000000000000000000000000000000000000000000000000001
12232422322224222342232324223222222323232422322332232222223420000000222422222222222322223342222223342432242222324233324232342331
12442332323322230233332233222232032232422334432303233423232230000000332222223222033242333222222202234223323243230222322322233231
10000000000000000000000000000000000000000000000000000000000000000000000000000000000000000000000000000000000000000000000000000001
10000000000000000000000000000000000000000000000000000000000000000000000000000000000000000000000000000000000000000000000000000001
10000000000000000000000000000000000000000000000000000000000000000000000000000000000000000000000000000000000000000000000000000001
10000000000000000000000000000000000000000000000000000000000000000000000000000000000000000000000000000000000000000000000000000001
10000000000000000000000000000000000000000000000000000000000000000000000000000000000000000000000000000000000000000000000000000001
10000000000000000000000000000000000000000000000000000000000000000000000000000000000000000000000000000000000000000000000000000001
10000000200000002000000030000000300000004000000040000000300000000000000020000000300000002000000020000000200000002000000020000001
10000000000000000000000000000000000000000000000000000000000000000000000000000000000000000000000000000000000000000000000000000001
10000000000000000000000000000000000000000000000000000000000000000000000000000000000000000000000000000000000000000000000000000001
10000000000000000000000000000000000000000000000000000000000000000000000000000000000000000000000000000000000000000000000000000001
10000000000000000000000000000000000000000000000000000000000000000000000000000000000000000000000000000000000000000000000000000001
10000000000000000000000000000000000000000000000000000000000000000000000000000000000000000000000000000000000000000000000000000001
10000000000000000000000000000000000000000000000000000000000000000000000000000000000000000000000000000000000000000000000000000001
13232232323233330334322222222233022322242432234402222322232230000000322223222324032423232323223403432223323232320342222232422321
12222222222222222222222222222222222222222222222222222222222220000000222222222222222222222222222222222222222222222222222222222221
12222222222222220222222222222222022222222222222202222222222220000000222222222222022222222222222202222222222222220222222222222221
10000000000000000000000000000000000000000000000000000000000000000000000000000000000000000000000000000000000000000000000000000001
10000000000000000000000000000000000000000000000000000000000000000000000000000000000000000000000000000000000000000000000000000001
10000000000000000000000000000000000000000000000000000000000000000000000000000000000000000000000000000000000000000000000000000001
10000000000000000000000000000000000000000000000000000000000000000000000000000000000000000000000000000000000000000000000000000001
10000000000000000000000000000000000000000000000000000000000000000000000000000000000000000000000000000000000000000000000000000001
10000000000000000000000000000000000000000000000000000000000000000000000000000000000000000000000000000000000000000000000000000001
10000000200000002000000020000000200000002000000020000000200000000000000020000000200000002000000020000000200000002000000020000001
10000000000000000000000000000000000000000000000000000000000000000000000000000000000000000000000000000000000000000000000000000001
10000000000000000000000000000000000000000000000000000000000000000000000000000000000000000000000000000000000000000000000000000001
10000000000000000000000000000000000000000000000000000000000000000000000000000000000000000000000000000000000000000000000000000001
10000000000000000000000000000000000000000000000000000000000000000000000000000000000000000000000000000000000000000000000000000001
10000000000000000000000000000000000000000000000000000000000000000000000000000000000000000000000000000000000000000000000000000001
10000000000000000000000000000000000000000000000000000000000000000000000000000000000000000000000000000000000000000000000000000001
12222222222222220222222222222222022222222222222202222222222220000000222222222222022222222222222202222222222222220222222222222221
12222222222222222222222222222222222222222222222222222222222220000000222222222222222222222222222222222222222222222222222222222221
12222222222222229222222222222222022222222222222202222222222220000000222222222222022222222222222202222222222222220222222222222221
10000000000000000000000000000000000000000000000000000000000000000000000000000000000000000000000000000000000000000000000000000001
10000000000000000000000000000000000000000000000000000000000000000000000000000000000000000000000000000000000000000000000000000001
10000000000000000000000000000000000000000000000000000000000000000000000000000000000000000000000000000000000000000000000000000001
10000000000000000000000000000000000000000000000000000000000000000000000000000000000000000000000000000000000000000000000000000001
10000000000000000000000000000000000000000000000000000000000000000000000000000000000000000000000000000000000000000000000000000001
10000000000000000000000000000000000000000000000000000000000000000000000000000000000000000000000000000000000000000000000000000001
10000000200000002000000020000000200000002000000020000000200000000000000020000000200000002000000020000000200000002000000020000001
10000000000000000000000000000000000000000000000000000000000000000000000000000000000000000000000000000000000000000000000000000001
10000000000000000000000000000000000000000000000000000000000000000000000000000000000000000000000000000000000000000000000000000001
10000000000000000000000000000000000000000000000000000000000000000000000000000000000000000000000000000000000000000000000000000001
10000000000000000000000000000000000000000000000000000000000000000000000000000000000000000000000000000000000000000000000000000001
10000000000000000000000000000000000000000000000000000000000000000000000000000000000000000000000000000000000000000000000000000001
10000000000000000000000000000000000000000000000000000000000000000000000000000000000000000000000000000000000000000000000000000001
12222222222222220222222222222222022222222222222202222222222220000000222222222222022222222222222202222222222222220222222222222221
12222222222222222222222222222222222222222222222222222222222220000000222222222222222222222222222222222222222222222222222222222221
12222222222222220222222222222222022222222222222202222222222220000000222222222222022222222222222202222222222222220222222222222221
10000000000000000000000000000000000000000000000000000000000000000000000000000000000000000000000000000000000000000000000000000001
10000000000000000000000000000000000000000000000000000000000000000000000000000000000000000000000000000000000000000000000000000001
10000000000000000000000000000000000000000000000000000000000000000000000000000000000000000000000000000000000000000000000000000001
10000000000000000000000000000000000000000000000000000000000000000000000000000000000000000000000000000000000000000000000000000001
10000000000000000000000000000000000000000000000000000000000000000000000000000000000000000000000000000000000000000000000000000001
10000000000000000000000000000000000000000000000000000000000000000000000000000000000000000000000000000000000000000000000000000001
10000000200000002000000020000000200000002000000020000000200000000000000020000000200000002000000020000000200000002000000020000001
10000000000000000000000000000000000000000000000000000000000000000000000000000000000000000000000000000000000000000000000000000001
10000000000000000000000000000000000000000000000000000000000000000000000000000000000000000000000000000000000000000000000000000001
1000000000000000000000000000000000000000000000000000000000000000P000000000000000000000000000000000000000000000000000000000000001
10000000000000000000000000000000000000000000000000000000000000000000000000000000000000000000000000000000000000000000000000000001
10000000000000000000000000000000000000000000000000000000000000000000000000000000000000000000000000000000000000000000000000000001
10000000000000000000000000000000000000000000000000000000000000000000000000000000000000000000000000000000000000000000000000000001
11111111111111111111111111111111111111111111111111111111111111111111111111111111111111111111111111111111111111111111111111111111
